0|0,0|0,0|0,0|0,0|0,0|0,0|0,0|0,0|0,0|0,0|0,0|0,0|0,0|0,0|0,0|0,0|0,0|0,0|0,0|0,0|0,0|0,0|0,0|0,0|0,0|0,0|0,0|0,0|0,0|0,0|0,0|0,0|0,0|0,0|0,0|0,0|0,0|0,0|0,0|0,0|0,0|0,0|0,0|0,0|0,0|0,0|0,0|0,0|0,0|0,0|0,0|0,0|0,0|0,0|0,0|0,0|0,0|0,0|0,0|0
0|0,0|0,0|0,0|0,0|0,0|0,0|0,0|0,0|0,0|0,0|0,0|0,0|0,0|0,0|0,0|0,0|0,0|0,0|0,0|0,0|0,0|0,0|0,0|0,0|0,0|0,0|0,0|0,0|0,0|0,0|0,0|0,0|0,0|0,0|0,0|0,0|0,0|0,0|0,0|0,0|0,0|0,0|0,0|0,0|0,0|0,0|0,0|0,0|0,0|0,0|0,0|0,0|0,0|0,0|0,0|0,0|0,0|0,0|0,0|0
0|0,0|0,0|0,0|0,0|0,0|0,0|0,0|0,0|0,0|0,0|0,0|0,0|0,0|0,0|0,0|0,0|0,0|0,0|0,0|0,0|0,0|0,0|0,0|0,0|0,0|0,0|0,0|0,0|0,0|0,0|0,0|0,0|0,0|0,0|0,0|0,0|0,0|0,0|0,0|0,0|0,0|0,0|0,0|0,0|0,0|0,0|0,0|0,0|0,0|0,0|0,0|0,0|0,0|0,0|0,0|0,0|0,0|0,0|0,0|0
0|0,0|0,0|0,0|0,0|0,0|0,0|0,0|0,0|0,0|0,0|0,0|0,0|0,0|0,0|0,0|0,0|0,0|0,0|0,0|0,0|0,0|0,0|0,0|0,0|0,0|0,0|0,0|0,0|0,0|0,0|0,0|0,0|0,0|0,0|0,0|0,0|0,0|0,0|0,0|0,0|0,0|0,0|0,0|0,0|0,0|0,0|0,0|0,0|0,0|0,0|0,0|0,0|0,0|0,0|0,0|0,0|0,0|0,0|0,0|0
0|0,0|0,0|0,0|0,0|0,0|0,0|0,0|0,0|0,0|0,0|0,0|0,0|0,0|0,0|0,0|0,0|0,0|0,0|0,0|0,0|0,0|0,0|0,0|0,0|0,0|0,0|0,0|0,0|0,0|0,0|0,0|0,0|0,0|0,0|0,0|0,0|0,1|2,1|2,1|2,1|2,1|2,1|2,1|2,1|2,1|2,1|2,1|2,1|2,1|2,1|2,1|2,0|0,0|0,0|0,0|0,0|0,0|0,0|0,0|0
0|0,0|0,0|0,0|0,0|0,0|0,0|0,0|0,0|0,0|0,0|0,0|0,0|0,0|0,0|0,0|0,0|0,0|0,0|0,0|0,0|0,0|0,0|0,0|0,0|0,0|0,0|0,0|0,0|0,0|0,0|0,0|0,0|0,0|0,0|0,0|0,0|0,1|2,0|0,0|0,0|0,0|0,0|0,0|0,0|0,0|0,0|0,0|0,0|0,0|0,0|0,1|2,0|0,0|0,0|0,0|0,0|0,0|0,0|0,0|0
0|0,0|0,0|0,0|0,0|0,0|0,0|0,0|0,0|0,0|0,0|0,0|0,0|0,0|0,0|0,0|0,0|0,0|0,0|0,0|0,0|0,0|0,0|0,0|0,0|0,0|0,0|0,0|0,0|0,0|0,0|0,0|0,0|0,0|0,0|0,0|0,0|0,1|2,0|0,0|0,0|0,0|0,0|0,0|0,0|0,0|0,0|0,0|0,0|0,0|0,0|0,9|0,0|0,0|0,0|0,0|0,0|0,0|0,0|0,0|0
0|0,0|0,0|0,0|0,0|0,0|0,0|0,0|0,0|0,0|0,0|0,0|0,0|0,0|0,0|0,0|0,0|0,0|0,0|0,0|0,0|0,0|0,0|0,0|0,0|0,0|0,0|0,0|0,0|0,0|0,0|0,0|0,0|0,0|0,0|0,0|0,0|0,1|2,0|0,0|0,0|0,0|0,1|2,1|2,1|2,1|2,1|2,1|2,0|0,0|0,0|0,9|0,0|0,0|0,0|0,0|0,0|0,0|0,0|0,0|0
0|0,0|0,0|0,0|0,0|0,0|0,0|0,0|0,0|0,0|0,0|0,0|0,0|0,0|0,0|0,0|0,0|0,0|0,0|0,0|0,0|0,0|0,0|0,0|0,0|0,0|0,0|0,0|0,0|0,0|0,0|0,0|0,0|0,0|0,0|0,0|0,0|0,1|2,0|0,0|0,0|0,0|0,1|2,0|0,0|0,0|0,0|0,0|0,0|0,0|0,0|0,1|2,0|0,0|0,0|0,0|0,0|0,0|0,0|0,0|0
0|0,0|0,0|0,0|0,0|0,0|0,0|0,0|0,0|0,0|0,0|0,0|0,0|0,0|0,0|0,0|0,0|0,0|0,0|0,0|0,0|0,0|0,0|0,0|0,0|0,0|0,0|0,0|0,0|0,0|0,0|0,0|0,0|0,0|0,0|0,0|0,0|0,1|2,0|0,0|0,0|0,0|0,1|2,0|0,0|0,0|0,1|2,1|2,1|2,0|0,0|0,1|2,0|0,0|0,0|0,0|0,0|0,0|0,0|0,0|0
0|0,0|0,0|0,0|0,0|0,0|0,0|0,1|2,1|2,1|2,1|2,1|2,1|2,1|2,1|2,1|2,1|2,0|0,0|0,0|0,0|0,0|0,0|0,0|0,0|0,0|0,0|0,0|0,0|0,0|0,0|0,0|0,0|0,0|0,0|0,0|0,0|0,1|2,0|0,0|0,0|0,0|0,1|2,0|0,0|0,0|0,0|0,0|0,1|2,0|0,0|0,1|2,0|0,0|0,0|0,0|0,0|0,0|0,0|0,0|0
0|0,0|0,0|0,0|0,0|0,0|0,0|0,1|2,0|0,0|0,0|0,0|0,0|0,0|0,0|0,0|0,1|2,0|0,0|0,0|0,0|0,0|0,0|0,0|0,0|0,0|0,0|0,0|0,0|0,0|0,0|0,0|0,0|0,0|0,0|0,0|0,0|0,1|2,1|2,1|2,0|0,0|0,1|2,0|0,0|0,0|0,0|0,0|0,1|2,0|0,0|0,1|2,0|0,0|0,0|0,0|0,0|0,0|0,0|0,0|0
0|0,0|0,0|0,0|0,0|0,0|0,0|0,1|2,0|0,0|0,0|0,0|0,1|2,1|2,1|2,0|0,1|2,1|2,1|2,1|2,1|2,1|2,1|2,1|2,1|2,1|2,1|2,1|2,1|2,1|2,1|2,1|2,1|2,1|2,1|2,1|2,1|2,1|2,0|0,1|2,0|0,0|0,1|2,0|0,0|0,0|0,0|0,0|0,1|2,0|0,0|0,1|2,0|0,0|0,0|0,0|0,0|0,0|0,0|0,0|0
0|0,0|0,0|0,0|0,0|0,0|0,0|0,1|2,0|0,0|0,0|0,0|0,1|2,0|0,1|2,0|0,0|0,0|0,0|0,0|0,0|0,0|0,0|0,0|0,1|2,0|0,0|0,1|2,0|0,1|2,0|0,0|0,0|0,0|0,0|0,0|0,0|0,0|0,0|0,1|2,0|0,0|0,1|2,0|0,0|0,0|0,0|0,0|0,1|2,0|0,0|0,1|2,0|0,0|0,0|0,0|0,0|0,0|0,0|0,0|0
0|0,0|0,0|0,0|0,0|0,0|0,0|0,1|2,0|0,0|0,0|0,0|0,1|2,0|0,0|0,0|0,0|0,0|0,0|0,0|0,0|0,0|0,0|0,0|0,1|2,0|0,0|0,1|2,0|0,1|2,0|0,0|0,0|0,0|0,0|0,0|0,0|0,0|0,0|0,1|2,0|0,1|2,1|2,0|0,0|0,0|0,0|0,0|0,1|2,0|0,0|0,1|2,0|0,0|0,0|0,0|0,0|0,0|0,0|0,0|0
0|0,0|0,0|0,0|0,0|0,0|0,0|0,1|2,0|0,0|0,0|0,0|0,1|2,0|0,0|0,0|0,0|0,0|0,0|0,0|0,0|0,0|0,0|0,0|0,1|2,0|0,0|0,1|2,0|0,1|2,0|0,0|0,0|0,0|0,0|0,0|0,0|0,0|0,0|0,1|2,0|0,0|0,0|0,0|0,0|0,0|0,0|0,0|0,1|2,0|0,0|0,1|2,0|0,0|0,0|0,0|0,0|0,0|0,0|0,0|0
0|0,0|0,0|0,0|0,0|0,0|0,0|0,1|2,0|0,0|0,0|0,0|0,1|2,0|0,0|0,1|2,1|2,1|2,0|0,0|0,1|2,1|2,1|2,1|2,1|2,0|0,0|0,1|2,0|0,1|2,1|2,1|2,1|2,1|2,1|2,1|2,0|0,0|0,0|0,1|2,0|0,0|0,0|0,0|0,0|0,0|0,0|0,0|0,1|2,0|0,0|0,1|2,0|0,0|0,0|0,0|0,0|0,0|0,0|0,0|0
0|0,0|0,0|0,0|0,0|0,0|0,0|0,1|2,0|0,0|0,0|0,0|0,1|2,0|0,0|0,1|2,0|0,1|2,0|0,0|0,1|2,0|0,0|0,0|0,0|0,0|0,0|0,1|2,0|0,0|0,0|0,0|0,0|0,0|0,0|0,1|2,0|0,0|0,0|0,1|2,0|0,0|0,0|0,0|0,0|3,0|3,0|0,0|0,0|0,0|0,0|0,1|2,0|0,0|0,0|0,0|0,0|0,0|0,0|0,0|0
0|0,0|0,0|0,0|0,0|0,0|0,0|0,1|2,0|0,0|0,0|0,0|0,1|2,0|0,0|0,1|2,0|0,1|2,0|0,0|0,1|2,0|0,0|0,1|2,1|2,1|2,0|0,0|0,0|0,0|0,1|2,1|2,1|2,0|0,0|0,1|2,0|0,0|0,0|0,1|2,0|0,0|0,0|0,0|0,0|3,0|3,0|0,0|0,0|0,0|0,0|0,1|2,0|0,0|0,0|0,0|0,0|0,0|0,0|0,0|0
0|0,0|0,0|0,0|0,0|0,0|0,0|0,1|2,0|0,0|0,0|0,0|0,1|2,0|0,0|0,1|2,0|0,1|2,0|0,0|0,1|2,0|0,0|0,1|2,0|0,1|2,0|0,0|0,0|0,0|0,0|0,0|0,1|2,0|0,0|0,1|2,0|0,0|0,0|0,1|2,0|0,0|0,0|0,0|0,0|0,0|0,0|0,0|0,1|2,0|0,0|0,1|2,0|0,0|0,0|0,0|0,0|0,0|0,0|0,0|0
0|0,0|0,0|0,0|0,0|0,0|0,0|0,1|2,0|0,1|2,1|2,1|2,1|2,0|0,0|0,1|2,0|0,1|2,1|2,1|2,1|2,0|0,0|0,1|2,0|0,1|2,0|0,0|0,0|0,0|0,0|0,0|0,1|2,0|0,0|0,1|2,1|2,0|0,0|0,1|2,1|2,1|2,1|2,0|0,0|0,0|0,0|0,0|0,1|2,0|0,0|0,1|2,0|0,0|0,0|0,0|0,0|0,0|0,0|0,0|0
0|0,0|0,0|0,0|0,0|0,0|0,0|0,1|2,0|0,1|2,0|0,0|0,0|0,0|0,0|0,1|2,0|0,0|0,0|0,0|0,0|0,0|0,0|0,0|0,0|0,1|2,1|2,1|2,1|2,1|2,1|2,1|2,1|2,0|0,0|0,0|0,0|0,0|0,0|0,0|0,0|0,0|0,1|2,1|2,0|0,0|0,0|0,0|0,1|2,0|0,0|0,1|2,0|0,0|0,0|0,0|0,0|0,0|0,0|0,0|0
0|0,0|0,0|0,0|0,0|0,0|0,0|0,1|2,0|0,1|2,0|0,0|0,0|0,0|0,0|0,1|2,0|0,0|0,0|0,0|0,0|0,0|0,0|0,0|0,0|0,0|0,0|0,0|0,0|0,0|0,0|0,0|0,0|0,0|0,0|0,0|0,0|0,0|0,0|0,0|0,0|0,0|0,0|0,1|2,1|2,1|2,0|0,0|0,1|2,0|0,0|0,1|2,0|0,0|0,0|0,0|0,0|0,0|0,0|0,0|0
0|0,0|0,0|0,0|0,0|0,0|0,0|0,1|2,0|0,1|2,0|0,0|0,1|2,0|0,0|0,1|2,0|0,0|0,0|0,0|0,0|0,0|0,0|0,0|0,0|0,1|2,1|2,1|2,1|2,1|2,1|2,1|2,1|2,1|2,1|2,1|2,1|2,1|2,1|2,1|2,0|0,0|0,0|0,1|2,0|0,1|2,0|0,0|0,1|2,0|0,0|0,1|2,0|0,0|0,0|0,0|0,0|0,0|0,0|0,0|0
0|0,0|0,0|0,0|0,0|0,0|0,0|0,1|2,0|0,1|2,0|0,0|0,1|2,0|0,0|0,1|2,0|0,0|0,0|0,0|0,0|0,0|0,0|0,0|0,0|0,1|2,0|0,0|0,0|0,0|0,0|0,0|0,0|0,1|2,0|0,0|0,0|0,0|0,0|0,1|2,0|0,0|0,0|0,1|2,0|0,1|2,0|0,0|0,1|2,0|0,0|0,1|2,0|0,0|0,0|0,0|0,0|0,0|0,0|0,0|0
0|0,0|0,0|0,0|0,0|0,0|0,0|0,1|2,0|0,1|2,0|0,0|0,1|2,0|0,0|0,1|2,0|0,0|0,0|0,0|0,0|0,0|0,0|0,0|0,0|0,1|2,0|0,0|0,0|0,0|0,0|0,0|0,0|0,1|2,0|0,0|0,0|0,0|0,0|0,1|2,0|0,0|0,0|0,1|2,0|0,1|2,0|0,0|0,1|2,0|0,0|0,1|2,0|0,0|0,0|0,0|0,0|0,0|0,0|0,0|0
0|0,0|0,0|0,0|0,0|0,0|0,0|0,1|2,0|0,1|2,1|2,1|2,1|2,0|0,0|0,1|2,0|0,0|0,0|0,0|0,0|0,0|0,0|0,0|0,0|0,1|2,1|2,1|2,1|2,1|2,1|2,0|0,1|2,1|2,1|2,1|2,0|0,0|0,0|0,0|0,0|0,0|0,0|0,0|0,0|0,1|2,0|0,0|0,1|2,0|0,0|0,1|2,0|0,0|0,0|0,0|0,0|0,0|0,0|0,0|0
0|0,0|0,0|0,0|0,0|0,0|0,0|0,1|2,0|0,1|2,0|0,0|0,1|2,0|0,0|0,1|2,0|0,0|0,0|0,0|0,0|0,0|0,0|0,0|0,0|0,1|2,0|0,0|0,0|0,0|0,1|2,0|0,1|2,0|0,0|0,1|2,0|0,0|0,1|2,0|0,0|0,0|0,0|0,0|0,0|0,1|2,0|0,0|0,1|2,0|0,0|0,1|2,0|0,0|0,0|0,0|0,0|0,0|0,0|0,0|0
0|0,0|0,0|0,0|0,0|0,0|0,0|0,1|2,0|0,1|2,0|0,0|0,1|2,0|0,0|0,1|2,0|0,0|0,0|0,0|0,0|0,0|0,0|0,0|0,0|0,1|2,0|0,0|0,0|0,0|0,1|2,0|0,1|2,0|0,0|0,1|2,1|2,1|2,1|2,1|2,1|2,1|2,1|2,0|0,0|0,1|2,0|0,0|0,1|2,0|0,0|0,1|2,0|0,0|0,0|0,0|0,0|0,0|0,0|0,0|0
0|0,0|0,0|0,0|0,0|0,0|0,0|0,1|2,0|0,1|2,0|0,0|0,1|2,0|0,0|0,1|2,0|0,0|0,0|0,0|0,0|0,0|0,1|2,1|2,1|2,1|2,1|2,1|2,0|0,0|0,1|2,0|0,1|2,0|0,0|0,0|0,0|0,0|0,0|0,0|0,0|0,0|0,1|2,0|0,0|0,1|2,0|0,0|0,1|2,1|2,1|2,1|2,0|0,0|0,0|0,0|0,0|0,0|0,0|0,0|0
0|0,0|0,0|0,0|0,0|0,0|0,0|0,1|2,0|0,1|2,0|0,0|0,1|2,0|0,0|0,1|2,0|0,0|0,0|0,0|0,0|0,0|0,1|2,0|0,0|0,0|0,0|0,1|2,0|0,0|0,1|2,0|0,1|2,0|0,0|0,0|0,0|0,0|0,0|0,0|0,0|0,0|0,1|2,0|0,0|0,1|2,0|0,0|0,0|0,0|0,0|0,1|2,0|0,0|0,0|0,0|0,0|0,0|0,0|0,0|0
0|0,0|0,0|0,0|0,0|0,0|0,0|0,1|2,1|2,1|2,0|0,0|0,0|0,0|0,0|0,1|2,1|2,0|0,0|0,1|2,1|2,1|2,1|2,0|0,0|0,0|0,0|0,1|2,0|0,0|0,1|2,0|0,1|2,0|0,0|0,1|2,1|2,1|2,1|2,1|2,1|2,1|2,1|2,0|0,0|0,1|2,0|0,0|0,0|0,0|0,0|0,1|2,0|0,0|0,0|0,0|0,0|0,0|0,0|0,0|0
0|0,0|0,0|0,0|0,0|0,0|0,0|0,1|2,0|0,1|2,0|0,0|0,0|0,0|0,0|0,0|0,1|2,0|0,0|0,0|0,0|0,0|0,0|0,0|0,0|0,0|0,0|0,1|2,0|0,0|0,1|2,0|0,1|2,0|0,0|0,0|0,0|0,0|0,0|0,0|0,0|0,0|0,0|0,0|0,0|0,0|0,0|0,0|0,0|0,0|0,0|0,1|2,0|0,0|0,0|0,0|0,0|0,0|0,0|0,0|0
0|0,0|0,0|0,0|0,0|0,0|0,0|0,1|2,0|0,1|2,0|0,0|0,0|0,0|0,0|0,0|0,1|2,0|0,0|0,0|0,0|0,0|0,0|0,0|0,0|0,0|0,0|0,1|2,0|0,0|0,1|2,0|0,1|2,0|0,0|0,0|0,0|0,0|0,0|0,0|0,0|0,0|0,0|0,0|0,0|0,0|0,0|0,0|0,1|2,0|0,0|0,1|2,0|0,0|0,0|0,0|0,0|0,0|0,0|0,0|0
0|0,0|0,0|0,0|0,0|0,0|0,0|0,1|2,0|0,1|2,0|0,0|0,1|2,0|0,0|0,1|2,1|2,1|2,1|2,1|2,1|2,1|2,1|2,0|0,0|0,0|0,0|0,1|2,0|0,0|0,1|2,0|0,1|2,0|0,0|0,1|2,1|2,1|2,1|2,1|2,1|2,1|2,1|2,1|2,1|2,1|2,0|0,0|0,1|2,0|0,0|0,1|2,0|0,0|0,0|0,0|0,0|0,0|0,0|0,0|0
0|0,0|0,0|0,0|0,0|0,0|0,0|0,1|2,0|0,1|2,0|0,0|0,1|2,0|0,0|0,1|2,0|0,0|0,0|0,0|0,0|0,0|0,1|2,0|0,0|0,0|0,0|0,1|2,0|0,0|0,1|2,0|0,0|0,0|0,0|0,1|2,0|0,0|0,0|0,0|0,0|0,0|0,0|0,0|0,0|0,1|2,0|0,0|0,1|2,0|0,0|0,1|2,0|0,0|0,0|0,0|0,0|0,0|0,0|0,0|0
0|0,0|0,0|0,0|0,0|0,0|0,0|0,1|2,0|0,1|2,0|0,0|0,1|2,0|0,0|0,1|2,0|0,0|0,1|2,1|2,1|2,1|2,1|2,0|0,0|0,0|0,0|0,1|2,0|0,0|0,1|2,0|0,0|0,0|0,0|0,1|2,0|0,0|0,0|0,0|0,0|0,0|0,0|0,0|0,0|0,1|2,0|0,0|0,1|2,0|0,0|0,1|2,0|0,0|0,0|0,0|0,0|0,0|0,0|0,0|0
0|0,0|0,0|0,0|0,0|0,0|0,0|0,1|2,0|0,1|2,0|0,0|0,1|2,0|0,0|0,1|2,0|0,0|0,0|0,0|0,0|0,0|0,0|0,0|0,0|0,0|0,0|0,1|2,0|0,0|0,1|2,1|2,1|2,1|2,1|2,1|2,0|0,0|0,0|0,0|0,0|0,0|0,0|0,0|0,0|0,1|2,0|0,0|0,1|2,1|2,1|2,1|2,0|0,0|0,0|0,0|0,0|0,0|0,0|0,0|0
0|0,0|0,0|0,0|0,0|0,0|0,0|0,1|2,0|0,1|2,0|0,0|0,1|2,0|0,0|0,1|2,0|0,0|0,0|0,0|0,0|0,0|0,0|0,0|0,0|0,0|0,0|0,1|2,0|0,0|0,0|0,0|0,0|0,0|0,0|0,0|0,0|0,0|0,0|0,0|0,0|0,0|0,0|0,0|0,0|0,1|2,0|0,0|0,1|2,0|0,0|0,1|2,0|0,0|0,0|0,0|0,0|0,0|0,0|0,0|0
0|0,0|0,0|0,0|0,0|0,0|0,0|0,1|2,0|0,1|2,0|0,0|0,1|2,0|0,0|0,1|2,0|0,0|0,1|2,1|2,1|2,1|2,1|2,1|2,1|2,0|0,0|0,1|2,0|0,0|0,1|2,1|2,1|2,1|2,1|2,1|2,0|0,0|0,0|0,0|0,0|0,0|0,0|0,0|0,0|0,1|2,0|0,0|0,1|2,0|0,0|0,1|2,0|0,0|0,0|0,0|0,0|0,0|0,0|0,0|0
0|0,0|0,0|0,0|0,0|0,0|0,0|0,1|2,0|0,1|2,0|0,0|0,1|2,0|0,0|0,1|2,0|0,0|0,1|2,0|0,0|0,0|0,0|0,0|0,0|0,0|0,0|0,1|2,0|0,0|0,1|2,0|0,0|0,0|0,0|0,1|2,0|0,0|0,0|0,0|0,0|0,0|0,0|0,0|0,0|0,1|2,0|0,0|0,1|2,0|0,0|0,1|2,0|0,0|0,0|0,0|0,0|0,0|0,0|0,0|0
0|0,0|0,0|0,0|0,0|0,0|0,0|0,1|2,0|0,1|2,0|0,0|0,1|2,0|0,0|0,1|2,0|0,0|0,1|2,0|0,0|0,0|0,0|0,0|0,0|0,0|0,0|0,1|2,0|0,0|0,1|2,0|0,0|0,0|0,0|0,1|2,0|0,0|0,0|0,0|0,0|0,0|0,0|0,0|0,0|0,1|2,0|0,0|0,1|2,0|0,0|0,1|2,0|0,0|0,0|0,0|0,0|0,0|0,0|0,0|0
0|0,0|0,0|0,0|0,0|0,0|0,0|0,1|2,0|0,1|2,0|0,0|0,1|2,0|0,0|0,1|2,0|0,0|0,1|2,0|0,0|0,0|0,0|0,0|0,0|0,0|0,0|0,1|2,0|0,0|0,1|2,0|0,0|0,0|0,0|0,1|2,0|0,0|0,0|0,0|0,0|0,0|0,0|0,0|0,0|0,1|2,0|0,0|0,1|2,0|0,0|0,1|2,0|0,0|0,0|0,0|0,0|0,0|0,0|0,0|0
0|0,0|0,0|0,0|0,0|0,0|0,0|0,1|2,0|0,1|2,0|0,0|0,1|2,1|2,1|2,1|2,0|0,0|0,1|2,0|0,0|0,0|0,0|0,0|0,0|0,0|0,0|0,1|2,0|0,0|0,1|2,0|0,0|0,0|0,0|0,1|2,1|2,1|2,1|2,1|2,1|2,0|0,0|0,0|0,0|0,1|2,1|2,1|2,1|2,0|0,0|0,1|2,0|0,0|0,0|0,0|0,0|0,0|0,0|0,0|0
0|0,0|0,0|0,0|0,0|0,0|0,0|0,1|2,0|0,1|2,0|0,0|0,0|0,0|0,0|0,0|0,0|0,0|0,1|2,0|0,0|0,0|0,0|0,0|0,0|0,0|0,0|0,1|2,0|0,0|0,1|2,0|0,0|0,0|0,0|0,0|0,0|0,0|0,0|0,0|0,1|2,0|0,0|0,1|2,0|0,0|0,0|0,0|0,0|0,0|0,0|0,1|2,0|0,0|0,0|0,0|0,0|0,0|0,0|0,0|0
0|0,0|0,0|0,0|0,0|0,0|0,0|0,1|2,0|0,1|2,0|0,0|0,0|0,0|0,0|0,0|0,0|0,0|0,1|2,0|0,0|0,0|0,0|0,0|0,0|0,0|0,0|0,1|2,0|0,0|0,1|2,0|0,0|0,0|0,0|0,0|0,0|0,0|0,0|0,0|0,1|2,0|0,0|0,1|2,0|0,0|0,0|0,0|0,0|0,0|0,0|0,1|2,0|0,0|0,0|0,0|0,0|0,0|0,0|0,0|0
0|0,0|0,0|0,0|0,0|0,0|0,0|0,1|2,0|0,1|2,0|0,0|0,0|0,1|2,1|2,1|2,1|2,1|2,1|2,0|0,0|0,0|0,0|0,0|0,0|0,0|0,0|0,1|2,0|0,0|0,1|2,0|0,0|0,0|0,0|0,0|0,0|0,0|0,0|0,0|0,1|2,0|0,0|0,1|2,1|2,1|2,1|2,1|2,1|2,1|2,1|2,1|2,0|0,0|0,0|0,0|0,0|0,0|0,0|0,0|0
0|0,0|0,0|0,0|0,0|0,0|0,0|0,1|2,0|0,0|0,0|0,0|0,0|0,0|0,0|0,0|0,0|0,0|0,0|0,0|0,0|0,0|0,0|0,0|0,0|0,0|0,0|0,1|2,0|0,0|0,1|2,0|0,0|0,0|0,0|0,0|0,0|0,0|0,0|0,0|0,1|2,0|0,0|0,0|0,0|0,0|0,0|0,0|0,0|0,0|0,0|0,9|0,0|0,0|0,0|0,0|0,0|0,0|0,0|0,0|0
0|0,0|0,0|0,0|0,0|0,0|0,0|0,1|2,0|0,0|0,0|0,0|0,0|0,0|0,0|0,0|0,0|0,0|0,1|2,0|0,0|0,1|2,1|2,1|2,1|2,1|2,1|2,1|2,0|0,0|0,1|2,0|0,0|0,0|0,0|0,0|0,0|0,0|0,0|0,0|0,1|2,0|0,0|0,0|0,0|0,0|0,0|0,0|0,0|0,0|0,0|0,9|0,0|0,0|0,0|0,0|0,0|0,0|0,0|0,0|0
0|0,0|0,0|0,0|0,0|0,0|0,0|0,1|2,1|2,1|2,1|2,1|2,1|2,1|2,1|2,1|2,0|0,0|0,1|2,0|0,0|0,0|0,0|0,0|0,0|0,0|0,0|0,0|0,0|0,1|2,1|2,0|0,0|0,0|0,0|0,0|0,0|0,0|0,0|0,0|0,1|2,1|2,1|2,1|2,1|2,1|2,1|2,1|2,1|2,1|2,1|2,1|2,0|0,0|0,0|0,0|0,0|0,0|0,0|0,0|0
0|0,0|0,0|0,0|0,0|0,0|0,0|0,0|0,0|0,0|0,0|0,0|0,0|0,0|0,0|0,1|2,0|0,0|0,1|2,0|0,0|0,0|0,0|0,0|0,0|0,0|0,0|0,0|0,0|0,1|2,0|0,0|0,0|0,0|0,0|0,0|0,0|0,0|0,0|0,0|0,0|0,0|0,0|0,0|0,0|0,0|0,0|0,0|0,0|0,0|0,0|0,0|0,0|0,0|0,0|0,0|0,0|0,0|0,0|0,0|0
0|0,0|0,0|0,0|0,0|0,0|0,0|0,0|0,0|0,0|0,0|0,0|0,0|0,0|0,0|0,1|2,1|2,1|2,1|2,1|2,1|2,1|2,1|2,1|2,1|2,1|2,1|2,1|2,1|2,1|2,0|0,0|0,0|0,0|0,0|0,0|0,0|0,0|0,0|0,0|0,0|0,0|0,0|0,0|0,0|0,0|0,0|0,0|0,0|0,0|0,0|0,0|0,0|0,0|0,0|0,0|0,0|0,0|0,0|0,0|0
0|0,0|0,0|0,0|0,0|0,0|0,0|0,0|0,0|0,0|0,0|0,0|0,0|0,0|0,0|0,0|0,0|0,0|0,0|0,0|0,0|0,0|0,0|0,0|0,0|0,0|0,0|0,0|0,0|0,0|0,0|0,0|0,0|0,0|0,0|0,0|0,0|0,0|0,0|0,0|0,0|0,0|0,0|0,0|0,0|0,0|0,0|0,0|0,0|0,0|0,0|0,0|0,0|0,0|0,0|0,0|0,0|0,0|0,0|0,0|0
0|0,0|0,0|0,0|0,0|0,0|0,0|0,0|0,0|0,0|0,0|0,0|0,0|0,0|0,0|0,0|0,0|0,0|0,0|0,0|0,0|0,0|0,0|0,0|0,0|0,0|0,0|0,0|0,0|0,0|0,0|0,0|0,0|0,0|0,0|0,0|0,0|0,0|0,0|0,0|0,0|0,0|0,0|0,0|0,0|0,0|0,0|0,0|0,0|0,0|0,0|0,0|0,0|0,0|0,0|0,0|0,0|0,0|0,0|0,0|0
0|0,0|0,0|0,0|0,0|0,0|0,0|0,0|0,0|0,0|0,0|0,0|0,0|0,0|0,0|0,0|0,0|0,0|0,0|0,0|0,0|0,0|0,0|0,0|0,0|0,0|0,0|0,0|0,0|0,0|0,0|0,0|0,0|0,0|0,0|0,0|0,0|0,0|0,0|0,0|0,0|0,0|0,0|0,0|0,0|0,0|0,0|0,0|0,0|0,0|0,0|0,0|0,0|0,0|0,0|0,0|0,0|0,0|0,0|0,0|0
0|0,0|0,0|0,0|0,0|0,0|0,0|0,0|0,0|0,0|0,0|0,0|0,0|0,0|0,0|0,0|0,0|0,0|0,0|0,0|0,0|0,0|0,0|0,0|0,0|0,0|0,0|0,0|0,0|0,0|0,0|0,0|0,0|0,0|0,0|0,0|0,0|0,0|0,0|0,0|0,0|0,0|0,0|0,0|0,0|0,0|0,0|0,0|0,0|0,0|0,0|0,0|0,0|0,0|0,0|0,0|0,0|0,0|0,0|0,0|0
0|0,0|0,0|0,0|0,0|0,0|0,0|0,0|0,0|0,0|0,0|0,0|0,0|0,0|0,0|0,0|0,0|0,0|0,0|0,0|0,0|0,0|0,0|0,0|0,0|0,0|0,0|0,0|0,0|0,0|0,0|0,0|0,0|0,0|0,0|0,0|0,0|0,0|0,0|0,0|0,0|0,0|0,0|0,0|0,0|0,0|0,0|0,0|0,0|0,0|0,0|0,0|0,0|0,0|0,0|0,0|0,0|0,0|0,0|0,0|0
0|0,0|0,0|0,0|0,0|0,0|0,0|0,0|0,0|0,0|0,0|0,0|0,0|0,0|0,0|0,0|0,0|0,0|0,0|0,0|0,0|0,0|0,0|0,0|0,0|0,0|0,0|0,0|0,0|0,0|0,0|0,0|0,0|0,0|0,0|0,0|0,0|0,0|0,0|0,0|0,0|0,0|0,0|0,0|0,0|0,0|0,0|0,0|0,0|0,0|0,0|0,0|0,0|0,0|0,0|0,0|0,0|0,0|0,0|0,0|0
0|0,0|0,0|0,0|0,0|0,0|0,0|0,0|0,0|0,0|0,0|0,0|0,0|0,0|0,0|0,0|0,0|0,0|0,0|0,0|0,0|0,0|0,0|0,0|0,0|0,0|0,0|0,0|0,0|0,0|0,0|0,0|0,0|0,0|0,0|0,0|0,0|0,0|0,0|0,0|0,0|0,0|0,0|0,0|0,0|0,0|0,0|0,0|0,0|0,0|0,0|0,0|0,0|0,0|0,0|0,0|0,0|0,0|0,0|0,0|0
0|0,0|0,0|0,0|0,0|0,0|0,0|0,0|0,0|0,0|0,0|0,0|0,0|0,0|0,0|0,0|0,0|0,0|0,0|0,0|0,0|0,0|0,0|0,0|0,0|0,0|0,0|0,0|0,0|0,0|0,0|0,0|0,0|0,0|0,0|0,0|0,0|0,0|0,0|0,0|0,0|0,0|0,0|0,0|0,0|0,0|0,0|0,0|0,0|0,0|0,0|0,0|0,0|0,0|0,0|0,0|0,0|0,0|0,0|0,0|0
