1|2,1|2,1|2,1|2,1|2,1|2,1|2,1|2,1|2,1|2,1|2,1|2,1|2,1|2,1|2,0|0,0|0,0|0,0|0,0|0,0|0,0|0,0|0,0|0,0|0,0|0,0|0,0|0,0|0,0|0,0|0,0|0,0|0,0|0,0|0,0|0,0|0,0|0,0|0,0|0,0|0,0|0,0|0,0|0,0|0,0|0,0|0,0|0,0|0,0|0,0|0,0|0,0|0,0|0,0|0,0|0,0|0,0|0,0|0,0|0
1|2,0|0,0|0,0|0,0|0,0|0,0|0,0|0,0|0,0|0,0|0,0|0,0|0,0|0,1|2,0|0,0|0,0|0,0|0,0|0,0|0,0|0,0|0,0|0,0|0,0|0,0|0,0|0,0|0,0|0,0|0,0|0,0|0,0|0,0|0,0|0,0|0,0|0,0|0,0|0,0|0,0|0,0|0,0|0,0|0,0|0,0|0,0|0,0|0,0|0,0|0,0|0,0|0,0|0,0|0,0|0,0|0,0|0,0|0,0|0
1|2,0|0,0|0,0|0,0|0,0|0,8|0,0|0,0|0,0|0,0|0,0|0,0|0,0|0,1|2,0|0,0|0,0|0,0|0,0|0,0|0,0|0,0|0,0|0,0|0,0|0,0|0,0|0,0|0,0|0,0|0,0|0,0|0,0|0,0|0,0|0,0|0,0|0,0|0,0|0,0|0,0|0,0|0,0|0,0|0,0|0,0|0,0|0,0|0,0|0,0|0,0|0,0|0,0|0,0|0,0|0,0|0,0|0,0|0,0|0
1|2,0|0,0|0,0|0,0|0,0|0,0|0,0|0,0|0,0|0,0|0,0|0,0|0,0|0,1|2,1|2,1|2,1|2,1|2,1|2,1|2,1|2,1|2,1|2,1|2,1|2,1|2,1|2,0|0,0|0,0|0,0|0,0|0,0|0,0|0,0|0,0|0,0|0,0|0,0|0,0|0,0|0,0|0,0|0,0|0,0|0,0|0,0|0,0|0,0|0,0|0,0|0,0|0,0|0,0|0,0|0,0|0,0|0,0|0,0|0
1|2,0|0,0|0,0|0,0|0,0|0,0|0,0|0,0|0,0|0,0|0,0|0,0|0,0|0,1|2,0|0,0|0,0|0,0|0,0|0,1|2,0|0,0|0,0|0,0|0,0|0,0|0,1|2,0|0,0|0,0|0,0|0,0|0,0|0,0|0,0|0,0|0,0|0,0|0,0|0,0|0,0|0,0|0,0|0,0|0,0|0,0|0,0|0,0|0,0|0,0|0,0|0,0|0,0|0,0|0,0|0,0|0,0|0,0|0,0|0
1|2,1|2,1|2,1|2,1|2,1|2,1|2,1|2,1|2,1|2,0|0,0|0,1|2,1|2,1|2,0|0,0|0,0|0,0|0,0|0,1|2,0|0,0|0,0|0,0|0,0|0,0|0,1|2,0|0,0|0,0|0,0|0,0|0,0|0,0|0,0|0,0|0,0|0,0|0,0|0,0|0,0|0,0|0,0|0,0|0,0|0,0|0,0|0,0|0,0|0,0|0,0|0,0|0,0|0,0|0,0|0,0|0,0|0,0|0,0|0
1|2,0|0,0|0,0|0,0|0,0|0,0|0,0|0,1|2,0|0,0|0,0|0,0|0,0|0,1|2,0|0,0|0,0|0,0|0,0|0,1|2,0|0,0|0,0|0,0|0,0|0,0|0,1|2,1|2,1|2,1|2,1|2,1|2,1|2,1|2,1|2,1|2,1|2,1|2,1|2,1|2,1|2,1|2,1|2,1|2,1|2,1|2,1|2,1|2,1|2,1|2,1|2,1|2,1|2,1|2,1|2,1|2,0|0,0|0,0|0
1|2,0|0,0|0,0|0,0|0,0|0,0|0,0|0,0|0,0|0,0|0,0|0,0|0,0|0,1|2,0|0,0|0,0|0,0|0,0|0,1|2,0|0,0|0,0|0,0|0,0|0,0|0,0|0,1|2,0|0,0|0,0|0,0|0,0|0,0|0,0|0,0|0,0|0,1|2,0|0,0|0,0|0,0|0,0|0,0|0,0|0,0|0,0|0,0|0,1|2,0|0,0|0,0|0,0|0,0|0,0|0,1|2,0|0,0|0,0|0
1|2,0|0,0|0,0|0,0|0,0|0,0|0,0|0,0|0,0|0,0|0,0|0,0|0,0|0,1|2,1|2,0|0,0|0,0|0,1|2,1|2,0|0,0|0,0|0,0|0,0|0,0|0,0|0,1|2,0|0,0|0,0|0,0|0,0|0,0|0,0|0,0|0,0|0,1|2,0|0,0|0,0|0,0|0,0|0,0|0,0|0,0|0,0|0,0|0,1|2,0|0,0|0,0|0,0|0,0|0,0|0,1|2,0|0,0|0,0|0
1|2,1|2,1|2,1|2,1|2,1|2,1|2,1|2,1|2,0|0,0|0,0|0,0|0,0|0,0|0,0|0,0|0,0|0,0|0,0|0,1|2,0|0,0|0,0|0,0|0,0|0,0|0,0|0,1|2,0|0,0|0,0|0,0|0,0|0,0|0,0|0,0|0,0|0,1|2,0|0,0|0,0|0,0|0,0|0,0|0,0|0,0|0,0|0,0|0,1|2,0|0,0|0,0|0,0|0,0|0,0|0,1|2,0|0,0|0,0|0
1|2,0|0,0|0,0|0,0|0,0|0,0|0,0|0,1|2,0|0,0|0,0|0,0|0,0|0,0|0,0|0,0|0,0|0,0|0,0|0,1|2,1|2,1|2,0|0,0|0,1|2,1|2,1|2,1|2,1|2,1|2,1|2,0|0,0|0,0|0,1|2,1|2,1|2,1|2,1|2,1|2,1|2,0|0,0|0,0|0,1|2,1|2,1|2,1|2,1|2,0|0,0|0,0|0,0|0,0|0,0|0,1|2,0|0,0|0,0|0
1|2,0|0,0|0,0|0,0|0,0|0,0|0,0|0,1|2,0|0,0|0,0|0,0|0,0|0,0|0,0|0,0|0,0|0,0|0,0|0,0|0,0|0,0|0,0|0,0|0,0|0,0|0,0|0,0|0,0|0,0|0,0|0,0|0,0|0,0|0,0|1,0|1,0|1,0|1,0|1,0|1,0|0,0|0,0|0,0|0,0|0,0|0,0|0,0|0,0|0,0|0,0|0,0|0,0|0,0|0,0|0,1|2,0|0,0|0,0|0
1|2,0|0,0|0,0|0,0|0,0|0,0|0,0|0,0|0,0|0,0|0,0|0,0|0,0|0,0|0,0|0,0|0,0|0,0|0,0|0,0|0,0|0,0|0,0|0,0|0,0|0,0|0,0|0,0|0,0|0,0|0,0|0,0|1,0|1,0|1,0|1,0|1,0|1,0|1,0|1,0|1,0|1,0|1,0|1,0|0,0|0,0|0,0|0,0|0,0|0,0|0,0|0,0|0,0|0,0|0,0|0,1|2,0|0,0|0,0|0
1|2,0|0,0|0,0|0,0|0,0|0,0|0,0|0,0|0,0|0,0|0,0|0,0|0,0|0,0|0,0|0,0|0,0|0,0|0,0|0,0|0,0|0,0|0,0|0,0|0,0|0,0|0,0|0,0|0,0|0,0|0,0|0,0|1,0|1,0|1,0|1,0|1,0|1,0|1,0|1,0|1,0|1,0|1,0|1,0|0,0|0,0|0,0|0,0|0,0|0,0|0,0|0,0|0,0|0,0|0,0|0,1|2,0|0,0|0,0|0
1|2,0|0,0|0,0|0,0|0,0|0,0|0,0|0,1|2,0|0,0|0,0|0,0|0,0|0,0|0,0|0,0|0,0|0,0|0,0|0,0|0,0|0,0|0,0|0,0|0,0|0,0|0,0|0,0|0,0|0,0|0,0|0,0|0,0|0,0|0,0|0,0|0,0|0,0|0,0|0,0|0,0|0,0|0,0|0,0|0,0|0,0|0,0|0,0|0,0|0,0|0,0|0,0|0,0|0,0|0,0|0,1|2,0|0,0|0,0|0
1|2,0|0,0|0,0|0,0|0,0|0,0|0,0|0,1|2,0|0,0|0,1|2,1|2,1|2,1|2,1|2,1|2,1|2,1|2,1|2,1|2,1|2,1|2,1|2,1|2,0|0,0|0,0|0,0|0,0|0,0|0,0|0,0|0,0|0,0|0,0|0,0|0,0|0,0|0,0|0,0|0,0|0,0|0,0|0,0|0,0|0,0|0,0|0,0|0,0|0,0|0,0|0,0|0,0|0,0|0,0|0,1|2,0|0,0|0,0|0
1|2,1|2,1|2,1|2,1|2,1|2,1|2,1|2,1|2,0|0,0|0,1|2,0|0,0|0,0|0,0|0,0|0,0|0,0|0,0|0,0|0,0|0,0|0,0|0,1|2,0|0,0|0,0|0,1|2,1|2,1|2,1|2,1|2,0|0,1|2,1|2,1|2,1|2,1|2,1|2,1|2,1|2,1|2,1|2,1|2,0|0,0|0,0|0,0|0,0|0,0|0,0|0,0|0,0|0,0|0,0|0,1|2,0|0,0|0,0|0
1|2,0|0,0|0,0|0,0|0,0|0,0|0,0|0,1|2,0|0,0|0,1|2,0|0,0|0,0|0,0|0,0|0,0|0,0|0,0|0,0|0,0|0,0|0,0|0,1|2,0|0,0|0,0|0,1|2,0|0,0|0,0|0,0|0,0|0,0|0,0|0,0|0,0|0,1|2,0|0,0|0,0|0,0|0,0|0,1|2,12|0,0|0,1|2,1|2,1|2,1|2,1|2,1|2,1|2,1|2,1|2,1|2,0|0,0|0,0|0
1|2,0|0,0|0,0|0,0|0,0|0,0|0,0|0,1|2,0|0,0|0,1|2,0|0,0|0,0|0,0|0,0|0,0|0,0|0,0|0,0|0,0|0,0|0,0|0,1|2,0|0,0|0,0|0,1|2,0|0,0|0,0|0,0|0,0|0,0|0,0|0,0|0,0|0,1|2,0|0,0|0,0|0,0|0,0|0,0|0,0|0,0|0,1|2,0|0,0|0,0|0,0|0,0|0,0|0,1|2,0|0,0|0,0|0,0|0,0|0
1|2,0|0,0|0,0|0,0|0,0|0,0|0,0|0,0|0,0|0,0|0,1|2,0|0,0|0,0|0,0|0,0|0,0|0,0|0,0|0,0|0,0|0,0|0,0|0,0|0,0|0,0|0,0|0,1|2,0|0,0|0,0|0,0|0,0|0,0|0,0|0,0|0,0|0,1|2,0|0,0|0,0|0,0|0,0|0,0|0,0|0,0|0,0|0,0|0,0|0,0|0,0|0,0|0,0|0,1|2,0|0,0|0,0|0,0|0,0|0
1|2,0|0,0|0,0|0,0|0,0|0,0|0,0|0,0|0,0|0,0|0,1|2,0|0,0|0,0|0,0|0,0|0,0|0,0|0,0|0,0|0,0|0,0|0,0|0,1|2,0|0,0|0,0|0,1|2,0|0,0|0,0|0,0|0,0|0,0|0,0|0,0|0,0|0,1|2,0|0,0|0,0|0,0|0,0|0,1|2,0|0,0|0,1|2,0|0,0|0,0|0,0|0,0|0,0|0,1|2,0|0,0|0,0|0,0|0,0|0
1|2,0|0,0|0,0|0,0|0,0|0,0|0,0|0,1|2,0|0,0|0,1|2,0|0,0|0,0|0,0|0,0|0,0|0,0|0,0|0,0|0,0|0,0|0,0|0,1|2,0|0,0|0,0|0,1|2,1|2,1|2,1|2,1|2,1|2,1|2,1|2,1|2,1|2,1|2,1|2,1|2,1|2,1|2,1|2,1|2,12|0,0|0,1|2,0|0,0|0,0|0,0|0,0|0,0|0,1|2,0|0,0|0,0|0,0|0,0|0
1|2,0|0,0|0,0|0,0|0,0|0,0|0,0|0,1|2,0|0,0|0,1|2,1|2,1|2,1|2,1|2,0|0,0|0,1|2,1|2,1|2,1|2,1|2,1|2,1|2,0|0,0|0,0|0,1|2,0|0,0|0,0|0,0|0,0|0,0|0,0|0,0|0,0|0,1|2,0|0,0|0,0|0,0|0,0|0,0|0,0|0,0|0,1|2,1|2,1|2,1|2,1|2,1|2,1|2,1|2,0|0,0|0,0|0,0|0,0|0
1|2,1|2,1|2,1|2,1|2,1|2,1|2,1|2,1|2,0|0,0|0,0|0,0|0,0|0,0|0,0|0,0|0,0|0,0|0,0|0,0|0,0|0,0|0,0|0,0|0,0|0,0|0,0|0,1|2,0|0,0|0,0|0,0|0,0|0,0|0,0|0,0|0,0|0,1|2,0|0,0|0,0|0,0|0,0|0,0|0,0|0,0|0,1|2,0|0,0|0,0|0,0|0,0|0,0|0,1|2,0|0,0|0,0|0,0|0,0|0
1|2,0|0,0|0,0|0,0|0,0|0,0|0,0|0,1|2,0|0,0|0,0|0,0|0,0|0,0|0,0|0,0|0,0|0,0|0,0|0,0|0,0|0,0|0,0|0,0|0,0|0,0|0,0|0,0|0,0|0,0|0,0|0,0|0,0|0,0|0,0|0,0|0,0|0,1|2,0|0,0|0,0|0,0|0,0|0,1|2,0|0,0|0,0|0,0|0,0|0,0|0,0|0,0|0,0|0,1|2,0|0,0|0,0|0,0|0,0|0
1|2,0|0,0|0,0|0,0|0,0|0,0|0,0|0,1|2,0|0,0|0,1|2,1|2,1|2,1|2,1|2,1|2,1|2,1|2,1|2,1|2,1|2,1|2,1|2,1|2,0|0,0|0,0|0,0|0,0|0,0|0,0|0,0|0,0|0,0|0,0|0,0|0,0|0,1|2,0|0,0|0,0|0,0|0,0|0,1|2,0|0,0|0,1|2,0|0,0|0,0|0,0|0,0|0,0|0,1|2,0|0,0|0,0|0,0|0,0|0
1|2,0|0,0|0,0|0,0|0,0|0,0|0,0|0,0|0,0|0,0|0,1|2,0|0,0|0,0|0,0|0,0|0,0|0,0|0,0|0,0|0,0|0,0|0,0|0,1|2,0|0,0|0,0|0,1|2,0|0,0|0,0|0,0|0,0|0,0|0,0|0,0|0,0|0,1|2,0|0,0|0,0|0,0|0,0|0,1|2,12|0,0|0,1|2,0|0,0|0,0|0,0|0,0|0,0|0,1|2,0|0,0|0,0|0,0|0,0|0
1|2,0|0,0|0,0|0,0|0,0|0,0|0,0|0,0|0,0|0,0|0,1|2,0|0,0|0,0|0,0|0,0|0,0|0,0|0,0|0,0|0,0|0,0|0,0|0,1|2,0|0,0|0,0|0,1|2,0|0,0|0,0|0,0|0,0|0,0|0,0|0,0|0,0|0,1|2,0|0,0|0,0|0,0|0,0|0,0|0,0|0,0|0,1|2,1|2,1|2,1|2,1|2,1|2,1|2,1|2,0|0,0|0,0|0,0|0,0|0
1|2,0|0,0|0,0|0,0|0,0|0,0|0,0|0,1|2,0|0,0|0,1|2,0|0,0|0,0|0,0|0,0|0,0|0,0|0,0|0,0|0,0|0,0|0,0|0,0|0,0|0,0|0,0|0,1|2,0|0,0|0,0|0,0|0,0|0,0|0,0|0,0|0,0|0,1|2,0|0,0|0,0|0,0|0,0|0,1|2,0|0,0|0,1|2,0|0,0|0,0|0,0|0,0|0,0|0,1|2,0|0,0|0,0|0,0|0,0|0
1|2,1|2,1|2,1|2,1|2,1|2,1|2,1|2,1|2,0|0,0|0,1|2,0|0,0|0,0|0,0|0,0|0,0|0,0|0,0|0,0|0,0|0,0|0,0|0,0|0,0|0,0|0,0|0,1|2,1|2,1|2,1|2,1|2,0|0,0|0,1|2,1|2,1|2,1|2,1|2,1|2,1|2,1|2,1|2,1|2,0|0,0|0,0|0,0|0,0|0,0|0,0|0,0|0,0|0,1|2,0|0,0|0,0|0,0|0,0|0
1|2,0|0,0|0,0|0,0|0,0|0,0|0,0|0,1|2,0|0,0|0,1|2,0|0,0|0,0|0,0|0,0|0,0|0,0|0,0|0,0|0,0|0,0|0,0|0,1|2,0|0,0|0,0|0,0|0,0|0,0|0,0|0,0|0,0|0,0|0,0|0,0|0,0|0,0|0,0|0,0|0,0|0,0|0,0|0,0|0,0|0,0|0,0|0,0|0,0|0,0|0,0|0,0|0,0|0,1|2,0|0,0|0,0|0,0|0,0|0
1|2,0|0,0|0,0|0,0|0,0|0,0|0,0|0,1|2,0|0,0|0,1|2,1|2,1|2,1|2,1|2,0|0,0|0,1|2,1|2,1|2,1|2,1|2,1|2,1|2,0|0,0|0,0|0,1|2,1|2,1|2,1|2,1|2,0|0,0|0,1|2,1|2,1|2,1|2,1|2,1|2,1|2,1|2,1|2,1|2,0|0,0|0,1|2,0|0,0|0,0|0,0|0,0|0,0|0,1|2,0|0,0|0,0|0,0|0,0|0
1|2,0|0,0|0,0|0,0|0,0|0,0|0,0|0,1|2,0|0,0|0,0|0,0|0,0|0,0|0,0|0,0|0,0|0,0|0,0|0,0|0,0|0,0|0,0|0,0|0,0|0,0|0,0|0,1|2,0|0,0|0,0|0,0|0,0|0,0|0,0|0,0|0,0|0,1|2,0|0,0|0,0|0,0|0,0|0,1|2,12|0,0|0,1|2,1|2,1|2,1|2,1|2,1|2,1|2,1|2,0|0,0|0,0|0,0|0,0|0
1|2,0|0,0|0,0|0,0|0,0|0,0|0,0|0,0|0,0|0,0|0,0|0,0|0,0|0,0|0,0|0,0|0,0|0,0|0,0|0,0|0,0|0,0|0,0|0,0|0,0|0,0|0,0|0,1|2,0|0,0|0,0|0,0|0,0|0,0|0,0|0,0|0,0|0,1|2,0|0,0|0,0|0,0|0,0|0,0|0,0|0,0|0,1|2,0|0,0|0,0|0,0|0,0|0,0|0,1|2,0|0,0|0,0|0,0|0,0|0
1|2,0|0,0|0,0|0,0|0,0|0,0|0,0|0,1|2,0|0,0|0,1|2,1|2,1|2,1|2,1|2,1|2,1|2,1|2,1|2,1|2,1|2,1|2,1|2,1|2,0|0,0|0,0|0,1|2,0|0,0|0,0|0,0|0,0|0,0|0,0|0,0|0,0|0,1|2,0|0,0|0,0|0,0|0,0|0,0|0,0|0,0|0,0|0,0|0,0|0,0|0,0|0,0|0,0|0,1|2,0|0,0|0,0|0,0|0,0|0
1|2,0|0,0|0,0|0,0|0,0|0,0|0,0|0,1|2,0|0,0|0,1|2,0|0,0|0,0|0,0|0,0|0,1|2,0|0,0|0,0|0,0|0,0|0,0|0,1|2,0|0,0|0,0|0,0|0,0|0,0|0,0|0,0|0,0|0,0|0,0|0,0|0,0|0,1|2,0|0,0|0,0|0,0|0,0|0,1|2,0|0,0|0,0|0,0|0,0|0,0|0,0|0,0|0,0|0,1|2,0|0,0|0,0|0,0|0,0|0
1|2,1|2,1|2,1|2,1|2,1|2,1|2,1|2,1|2,0|0,0|0,0|0,0|0,0|0,0|0,0|0,0|0,1|2,0|0,0|0,0|0,0|0,0|0,0|0,0|0,0|0,0|0,0|0,0|0,0|0,0|0,0|0,0|0,0|0,0|0,0|0,0|0,0|0,1|2,0|0,0|0,0|0,0|0,0|0,1|2,0|0,0|0,1|2,0|0,0|0,0|0,0|0,0|0,0|0,1|2,0|0,0|0,0|0,0|0,0|0
1|2,0|0,0|0,0|0,0|0,0|0,0|0,0|0,1|2,0|0,0|0,1|2,0|0,0|0,0|0,0|0,0|0,1|2,0|0,0|0,0|0,0|0,0|0,0|0,1|2,0|0,0|0,0|0,1|2,0|0,0|0,0|0,0|0,0|0,0|0,0|0,0|0,0|0,1|2,0|0,0|0,0|0,0|0,0|0,0|0,0|0,0|0,1|2,1|2,1|2,1|2,1|2,1|2,1|2,1|2,0|0,0|0,0|0,0|0,0|0
1|2,0|0,0|0,0|0,0|0,0|0,0|0,0|0,1|2,0|0,0|0,1|2,0|0,0|0,0|0,0|0,0|0,1|2,0|0,0|0,0|0,0|0,0|0,0|0,1|2,0|0,0|0,0|0,1|2,0|0,0|0,0|0,0|0,0|0,0|0,0|0,0|0,0|0,1|2,0|0,0|0,0|0,0|0,0|0,0|0,0|0,0|0,1|2,0|0,0|0,0|0,0|0,0|0,0|0,1|2,0|0,0|0,0|0,0|0,0|0
1|2,0|0,0|0,0|0,0|0,0|0,0|0,0|0,0|0,0|0,0|0,0|0,0|0,0|0,0|0,0|0,0|0,1|2,0|0,0|0,0|0,0|0,0|0,0|0,0|0,0|0,0|0,0|0,1|2,0|0,0|0,0|0,0|0,0|0,0|0,0|0,0|0,0|0,1|2,0|0,0|0,0|0,0|0,0|0,1|2,0|0,0|0,0|0,0|0,0|0,0|0,0|0,0|0,0|0,1|2,0|0,0|0,0|0,0|0,0|0
1|2,0|0,0|0,0|0,0|0,0|0,0|0,0|0,0|0,0|0,0|0,1|2,0|0,0|0,0|0,0|0,0|0,1|2,0|0,0|0,0|0,0|0,0|0,0|0,1|2,0|0,0|0,0|0,1|2,1|2,1|2,1|2,1|2,1|2,1|2,1|2,1|2,1|2,1|2,1|2,1|2,1|2,1|2,1|2,1|2,0|0,0|0,0|0,0|0,0|0,0|0,0|0,0|0,0|0,1|2,0|0,0|0,0|0,0|0,0|0
1|2,0|0,0|0,0|0,0|0,0|0,0|0,0|0,1|2,0|0,0|0,1|2,1|2,1|2,1|2,1|2,1|2,1|2,1|2,1|2,1|2,1|2,1|2,1|2,1|2,0|0,0|0,0|0,1|2,0|0,0|0,0|0,0|0,1|2,0|0,0|0,0|0,0|0,1|2,0|0,0|0,0|0,0|0,0|0,1|2,0|0,0|0,1|2,0|0,0|0,0|0,0|0,0|0,0|0,1|2,0|0,0|0,0|0,0|0,0|0
1|2,1|2,1|2,1|2,1|2,1|2,1|2,1|2,1|2,0|0,0|0,1|2,0|0,0|0,0|0,0|0,0|0,1|2,0|0,0|0,0|0,0|0,0|0,0|0,1|2,0|0,0|0,0|0,1|2,0|0,0|0,0|0,0|0,1|2,0|0,0|0,0|0,0|0,1|2,0|0,0|0,0|0,0|0,0|0,0|0,0|0,0|0,1|2,1|2,1|2,1|2,1|2,1|2,1|2,1|2,0|0,0|0,0|0,0|0,0|0
1|2,0|0,0|0,0|0,0|0,0|0,0|0,0|0,1|2,0|0,0|0,0|0,0|0,0|0,0|0,0|0,0|0,1|2,0|0,0|0,0|0,0|0,0|0,0|0,0|0,0|0,0|0,0|0,1|2,0|0,0|0,0|0,0|0,1|2,0|0,0|0,0|0,0|0,1|2,0|0,0|0,0|0,0|0,0|0,1|2,0|0,0|0,1|2,0|0,0|0,0|0,0|0,0|0,0|0,1|2,0|0,0|0,0|0,0|0,0|0
1|2,0|0,0|0,0|0,0|0,0|0,0|0,0|0,1|2,0|0,0|0,1|2,0|0,0|0,0|0,0|0,0|0,1|2,0|0,0|0,0|0,0|0,0|0,0|0,1|2,0|0,0|0,0|0,1|2,1|2,0|0,0|0,1|2,1|2,1|2,0|0,0|0,1|2,1|2,1|2,1|2,1|2,1|2,1|2,1|2,0|0,0|0,0|0,0|0,0|0,0|0,0|0,0|0,0|0,1|2,0|0,0|0,0|0,0|0,0|0
1|2,0|0,0|0,0|0,0|0,0|0,0|0,0|0,0|0,0|0,0|0,1|2,0|0,0|0,0|0,0|0,0|0,1|2,0|0,0|0,0|0,0|0,0|0,0|0,1|2,0|0,0|0,0|0,0|0,0|0,0|0,0|0,0|0,0|0,0|0,0|0,0|0,0|0,0|0,0|0,0|0,0|0,0|0,0|0,0|0,0|0,0|0,0|0,0|0,0|0,0|0,0|0,0|0,0|0,1|2,0|0,0|0,0|0,0|0,0|0
1|2,0|0,0|0,0|0,0|0,0|0,0|0,0|0,0|0,0|0,0|0,0|0,0|0,0|0,0|0,0|0,0|0,1|2,0|0,0|0,0|0,0|0,0|0,0|0,0|0,0|0,0|0,0|0,0|0,0|0,0|0,0|0,0|0,0|0,0|0,0|0,0|0,0|0,0|0,0|0,0|0,0|0,0|0,0|0,0|0,0|0,0|0,1|2,0|0,0|0,0|0,0|0,0|0,0|0,1|2,0|0,0|0,0|0,0|0,0|0
1|2,0|0,0|0,0|0,0|0,0|0,0|0,0|0,1|2,0|0,0|0,1|2,0|0,0|0,0|0,0|0,0|0,1|2,0|0,0|0,0|0,0|0,0|0,0|0,1|2,0|0,0|0,0|0,0|0,0|0,0|0,0|0,0|0,0|0,0|0,0|0,0|0,0|0,0|0,0|0,0|0,0|0,0|0,0|0,0|0,0|0,0|0,1|2,1|2,1|2,1|2,1|2,1|2,1|2,1|2,0|0,0|0,0|0,0|0,0|0
1|2,1|2,1|2,1|2,1|2,1|2,1|2,1|2,1|2,0|0,0|0,1|2,1|2,1|2,1|2,1|2,1|2,1|2,1|2,1|2,1|2,1|2,1|2,1|2,1|2,0|0,0|0,0|0,0|0,0|0,0|0,0|0,0|0,0|0,0|0,0|0,0|0,0|0,0|0,0|0,0|0,0|0,0|0,0|0,0|0,0|0,0|0,1|2,0|0,0|0,0|0,0|0,0|0,0|0,1|2,0|0,0|0,0|0,0|0,0|0
1|2,0|0,0|0,0|0,0|0,0|0,0|0,0|0,1|2,0|0,0|0,0|0,0|0,0|0,0|0,0|0,0|0,0|0,0|0,0|0,0|0,0|0,0|0,0|0,0|0,0|0,0|0,0|0,0|0,0|0,0|0,0|0,0|0,0|0,0|0,0|0,0|0,0|0,0|0,0|0,0|0,0|0,0|0,0|0,0|0,0|0,0|0,0|0,0|0,0|0,0|0,0|0,0|0,0|0,1|2,0|0,0|0,0|0,0|0,0|0
1|2,0|0,0|0,0|0,0|0,0|0,0|0,0|0,0|0,0|0,0|0,0|0,0|0,0|0,0|0,0|0,0|0,0|0,0|0,0|0,0|0,0|0,0|0,0|0,0|0,0|0,0|0,0|0,0|0,0|0,0|0,0|0,0|0,0|0,0|0,0|0,0|0,0|0,0|0,0|0,0|0,0|0,0|0,0|0,0|0,0|0,0|0,0|0,0|0,0|0,0|0,0|0,0|0,0|0,1|2,0|0,0|0,0|0,0|0,0|0
1|2,0|0,0|0,0|0,0|0,0|0,0|0,0|0,0|0,0|0,0|0,0|0,0|0,0|0,0|0,0|0,0|0,0|0,1|2,1|2,1|2,0|0,0|0,0|0,1|2,1|2,1|2,1|2,1|2,1|2,1|2,1|2,1|2,1|2,1|2,1|2,1|2,0|0,0|0,0|0,0|0,0|0,0|0,0|0,0|0,0|0,0|0,1|2,0|0,0|0,0|0,0|0,0|0,0|0,1|2,0|0,0|0,0|0,0|0,0|0
1|2,0|0,0|0,0|0,0|0,0|0,0|0,0|0,1|2,0|0,0|0,0|0,0|0,0|0,0|0,0|0,0|0,0|0,1|2,0|0,0|0,0|0,0|0,0|0,0|0,0|0,0|0,0|0,0|0,0|0,0|0,0|0,0|0,0|0,0|0,0|0,1|2,0|0,0|0,0|0,0|0,0|0,0|0,0|0,0|0,0|0,0|0,1|2,1|2,1|2,1|2,1|2,1|2,1|2,1|2,0|0,0|0,0|0,0|0,0|0
1|2,1|2,1|2,1|2,1|2,1|2,1|2,1|2,1|2,1|2,1|2,1|2,1|2,1|2,1|2,0|0,0|0,0|0,1|2,0|0,0|0,0|0,0|0,0|0,0|0,0|0,0|0,0|0,0|0,0|0,0|0,0|0,0|0,0|0,0|0,0|0,1|2,0|0,0|0,0|0,0|0,0|0,0|0,0|0,0|0,0|0,0|0,0|0,0|0,0|0,0|0,0|0,0|0,0|0,1|2,0|0,0|0,0|0,0|0,0|0
1|2,0|0,0|0,0|0,0|0,0|0,0|0,0|0,0|0,0|0,0|0,0|0,0|0,0|0,1|2,0|0,0|0,0|0,1|2,0|0,0|0,0|0,0|0,0|0,0|0,0|0,0|0,0|0,0|0,0|0,0|0,0|0,0|0,0|0,0|0,0|0,1|2,0|0,0|0,0|0,0|0,0|0,0|0,0|0,0|0,0|0,0|0,0|0,0|0,0|0,0|0,0|0,0|0,0|0,1|2,0|0,0|0,0|0,0|0,0|0
1|2,0|0,0|0,0|0,0|0,0|0,0|0,0|0,0|0,0|0,0|0,0|0,0|0,0|0,0|0,0|0,0|0,0|0,1|2,0|0,0|0,0|0,0|0,0|0,0|0,0|0,0|0,0|0,0|0,0|0,0|0,0|0,0|0,0|0,0|0,0|0,1|2,0|0,0|0,0|0,0|0,0|0,0|0,0|0,0|0,0|0,0|0,0|0,0|0,0|0,0|0,0|0,0|0,0|0,1|2,0|0,0|0,0|0,0|0,0|0
1|2,0|0,0|0,0|0,0|0,0|0,0|0,0|0,0|0,0|0,0|0,0|0,0|0,0|0,1|2,0|0,0|0,0|0,1|2,0|0,0|0,0|0,0|0,0|0,0|0,0|0,0|0,0|0,0|0,0|0,0|0,0|0,0|0,0|0,0|0,0|0,1|2,0|0,0|0,0|0,0|0,0|0,0|0,0|0,0|0,0|0,0|0,0|0,0|0,0|0,0|0,0|0,0|0,0|0,1|2,0|0,0|0,0|0,0|0,0|0
1|2,1|2,1|2,1|2,1|2,1|2,1|2,1|2,1|2,1|2,1|2,1|2,1|2,1|2,1|2,1|2,1|2,1|2,1|2,1|2,1|2,1|2,1|2,1|2,1|2,1|2,1|2,1|2,1|2,1|2,1|2,1|2,1|2,1|2,1|2,1|2,1|2,1|2,1|2,1|2,1|2,1|2,1|2,1|2,1|2,1|2,1|2,1|2,1|2,1|2,1|2,1|2,1|2,1|2,1|2,0|0,0|0,0|0,0|0,0|0
0|0,0|0,0|0,0|0,0|0,0|0,0|0,0|0,0|0,0|0,0|0,0|0,0|0,0|0,0|0,0|0,0|0,0|0,0|0,0|0,0|0,0|0,0|0,0|0,0|0,0|0,0|0,0|0,0|0,0|0,0|0,0|0,0|0,0|0,0|0,0|0,0|0,0|0,0|0,0|0,0|0,0|0,0|0,0|0,0|0,0|0,0|0,0|0,0|0,0|0,0|0,0|0,0|0,0|0,0|0,0|0,0|0,0|0,0|0,0|0
0|0,0|0,0|0,0|0,0|0,0|0,0|0,0|0,0|0,0|0,0|0,0|0,0|0,0|0,0|0,0|0,0|0,0|0,0|0,0|0,0|0,0|0,0|0,0|0,0|0,0|0,0|0,0|0,0|0,0|0,0|0,0|0,0|0,0|0,0|0,0|0,0|0,0|0,0|0,0|0,0|0,0|0,0|0,0|0,0|0,0|0,0|0,0|0,0|0,0|0,0|0,0|0,0|0,0|0,0|0,0|0,0|0,0|0,0|0,0|0
